{
  "name": "GMMK Pro",
  "vendorProductId": 839864388,
  "macros": ["", "", "", "", "", "", "", "", "", "", "", "", "", "", "", ""],
  "layers": [
    [
      "KC_LSFT",
      "KC_MPLY",
      "KC_NO",
      "KC_LEFT",
      "MO(1)",
      "KC_RGHT",
      "KC_LCTL",
      "KC_F5",
      "KC_Q",
      "KC_TAB",
      "KC_A",
      "KC_ESC",
      "KC_Z",
      "KC_PGUP",
      "KC_GRV",
      "KC_1",
      "KC_W",
      "KC_CAPS",
      "KC_S",
      "KC_NO",
      "KC_X",
      "KC_PGDN",
      "KC_F1",
      "KC_2",
      "KC_E",
      "KC_F3",
      "KC_D",
      "KC_F4",
      "KC_C",
      "KC_UP",
      "KC_F2",
      "KC_3",
      "KC_R",
      "KC_T",
      "KC_F",
      "KC_G",
      "KC_V",
      "KC_B",
      "KC_5",
      "KC_4",
      "KC_U",
      "KC_Y",
      "KC_J",
      "KC_H",
      "KC_M",
      "KC_N",
      "KC_6",
      "KC_7",
      "KC_I",
      "KC_RBRC",
      "KC_K",
      "KC_F6",
      "KC_COMM",
      "KC_DEL",
      "KC_EQL",
      "KC_8",
      "KC_O",
      "KC_F7",
      "KC_L",
      "KC_DOWN",
      "KC_DOT",
      "KC_END",
      "KC_F8",
      "KC_9",
      "KC_P",
      "KC_LBRC",
      "KC_SCLN",
      "KC_QUOT",
      "KC_NO",
      "KC_SLSH",
      "KC_MINS",
      "KC_0",
      "KC_LGUI",
      "KC_RSFT",
      "TG(1)",
      "KC_LALT",
      "KC_SPC",
      "KC_RALT",
      "KC_NO",
      "KC_PSCR",
      "KC_NO",
      "KC_BSPC",
      "KC_BSLS",
      "KC_F11",
      "KC_ENT",
      "KC_F12",
      "KC_F9",
      "KC_F10"
    ],
    [
      "KC_MS_BTN1",
      "KC_MPLY",
      "KC_NO",
      "KC_MS_LEFT",
      "MO(0)",
      "KC_MS_RIGHT",
      "KC_TRNS",
      "KC_MPRV",
      "KC_TRNS",
      "KC_TRNS",
      "KC_TRNS",
      "TG(1)",
      "KC_TRNS",
      "KC_MS_WH_DOWN",
      "KC_TRNS",
      "RGB_TOG",
      "RGB_VAI",
      "KC_TRNS",
      "RGB_VAD",
      "KC_NO",
      "RGB_HUI",
      "KC_MS_WH_UP",
      "KC_MYCM",
      "KC_TRNS",
      "KC_TRNS",
      "KC_CALC",
      "KC_TRNS",
      "KC_MSEL",
      "KC_TRNS",
      "KC_MS_UP",
      "KC_WWW_HOME",
      "KC_TRNS",
      "KC_TRNS",
      "KC_TRNS",
      "KC_TRNS",
      "KC_TRNS",
      "KC_TRNS",
      "KC_TRNS",
      "KC_TRNS",
      "KC_TRNS",
      "KC_TRNS",
      "KC_TRNS",
      "RGB_SPD",
      "KC_TRNS",
      "KC_TRNS",
      "MAGIC_TOGGLE_NKRO",
      "KC_TRNS",
      "KC_TRNS",
      "RGB_MOD",
      "KC_TRNS",
      "RGB_RMOD",
      "KC_MNXT",
      "KC_TRNS",
      "KC_MS_ACCEL0",
      "KC_TRNS",
      "KC_TRNS",
      "KC_TRNS",
      "KC_MPLY",
      "RGB_SPI",
      "KC_MS_DOWN",
      "KC_TRNS",
      "KC_MS_ACCEL1",
      "KC_MSTP",
      "KC_TRNS",
      "KC_TRNS",
      "KC_TRNS",
      "KC_TRNS",
      "KC_TRNS",
      "KC_NO",
      "KC_TRNS",
      "KC_TRNS",
      "KC_TRNS",
      "KC_TRNS",
      "KC_MS_BTN2",
      "TG(1)",
      "KC_TRNS",
      "KC_TRNS",
      "KC_TRNS",
      "KC_NO",
      "KC_TRNS",
      "KC_NO",
      "KC_TRNS",
      "RESET",
      "KC_VOLU",
      "KC_TRNS",
      "KC_TRNS",
      "KC_MUTE",
      "KC_VOLD"
    ],
    [
      "KC_TRNS",
      "KC_TRNS",
      "KC_TRNS",
      "KC_TRNS",
      "KC_TRNS",
      "KC_TRNS",
      "KC_TRNS",
      "KC_TRNS",
      "KC_TRNS",
      "KC_TRNS",
      "KC_TRNS",
      "KC_TRNS",
      "KC_TRNS",
      "KC_TRNS",
      "KC_TRNS",
      "KC_TRNS",
      "KC_TRNS",
      "KC_TRNS",
      "KC_TRNS",
      "KC_TRNS",
      "KC_TRNS",
      "KC_TRNS",
      "KC_TRNS",
      "KC_TRNS",
      "KC_TRNS",
      "KC_TRNS",
      "KC_TRNS",
      "KC_TRNS",
      "KC_TRNS",
      "KC_TRNS",
      "KC_TRNS",
      "KC_TRNS",
      "KC_TRNS",
      "KC_TRNS",
      "KC_TRNS",
      "KC_TRNS",
      "KC_TRNS",
      "KC_TRNS",
      "KC_TRNS",
      "KC_TRNS",
      "KC_TRNS",
      "KC_TRNS",
      "KC_TRNS",
      "KC_TRNS",
      "KC_TRNS",
      "KC_TRNS",
      "KC_TRNS",
      "KC_TRNS",
      "KC_TRNS",
      "KC_TRNS",
      "KC_TRNS",
      "KC_TRNS",
      "KC_TRNS",
      "KC_TRNS",
      "KC_TRNS",
      "KC_TRNS",
      "KC_TRNS",
      "KC_TRNS",
      "KC_TRNS",
      "KC_TRNS",
      "KC_TRNS",
      "KC_TRNS",
      "KC_TRNS",
      "KC_TRNS",
      "KC_TRNS",
      "KC_TRNS",
      "KC_TRNS",
      "KC_TRNS",
      "KC_TRNS",
      "KC_TRNS",
      "KC_TRNS",
      "KC_TRNS",
      "KC_TRNS",
      "KC_TRNS",
      "KC_TRNS",
      "KC_TRNS",
      "KC_TRNS",
      "KC_TRNS",
      "KC_TRNS",
      "KC_TRNS",
      "KC_TRNS",
      "KC_TRNS",
      "KC_TRNS",
      "KC_TRNS",
      "KC_TRNS",
      "KC_TRNS",
      "KC_TRNS",
      "KC_TRNS"
    ],
    [
      "KC_TRNS",
      "KC_TRNS",
      "KC_TRNS",
      "KC_TRNS",
      "KC_TRNS",
      "KC_TRNS",
      "KC_TRNS",
      "KC_TRNS",
      "KC_TRNS",
      "KC_TRNS",
      "KC_TRNS",
      "KC_TRNS",
      "KC_TRNS",
      "KC_TRNS",
      "KC_TRNS",
      "KC_TRNS",
      "KC_TRNS",
      "KC_TRNS",
      "KC_TRNS",
      "KC_TRNS",
      "KC_TRNS",
      "KC_TRNS",
      "KC_TRNS",
      "KC_TRNS",
      "KC_TRNS",
      "KC_TRNS",
      "KC_TRNS",
      "KC_TRNS",
      "KC_TRNS",
      "KC_TRNS",
      "KC_TRNS",
      "KC_TRNS",
      "KC_TRNS",
      "KC_TRNS",
      "KC_TRNS",
      "KC_TRNS",
      "KC_TRNS",
      "KC_TRNS",
      "KC_TRNS",
      "KC_TRNS",
      "KC_TRNS",
      "KC_TRNS",
      "KC_TRNS",
      "KC_TRNS",
      "KC_TRNS",
      "KC_TRNS",
      "KC_TRNS",
      "KC_TRNS",
      "KC_TRNS",
      "KC_TRNS",
      "KC_TRNS",
      "KC_TRNS",
      "KC_TRNS",
      "KC_TRNS",
      "KC_TRNS",
      "KC_TRNS",
      "KC_TRNS",
      "KC_TRNS",
      "KC_TRNS",
      "KC_TRNS",
      "KC_TRNS",
      "KC_TRNS",
      "KC_TRNS",
      "KC_TRNS",
      "KC_TRNS",
      "KC_TRNS",
      "KC_TRNS",
      "KC_TRNS",
      "KC_TRNS",
      "KC_TRNS",
      "KC_TRNS",
      "KC_TRNS",
      "KC_TRNS",
      "KC_TRNS",
      "KC_TRNS",
      "KC_TRNS",
      "KC_TRNS",
      "KC_TRNS",
      "KC_TRNS",
      "KC_TRNS",
      "KC_TRNS",
      "KC_TRNS",
      "KC_TRNS",
      "KC_TRNS",
      "KC_TRNS",
      "KC_TRNS",
      "KC_TRNS",
      "KC_TRNS"
    ]
  ],
  "encoders": [
    [
      ["KC_VOLD", "KC_VOLU"],
      ["KC_MRWD", "KC_MFFD"],
      ["KC_TRNS", "KC_TRNS"],
      ["KC_TRNS", "KC_TRNS"]
    ]
  ]
}